#####
###\#
### #
##* #
#R. #
#   #
#*  #
##L##