####################
#. \ \...* #......*#
##....#* ... ...@*\#
#.#..*.#.. \ ...!. #
#.... *.#.*\\*..\..#
#*  *\*.#R.\##*....#
#*.#. \@*. .**##. \#
##.####...* \*.....#
##...**.*...L####..#
##. .*.@..*..#..*.*#
###.... .\\....*** #
#..**..\* #*.. \..\#
#..\.*..\*#####*@ .#
#... .... *#*####..#
##.*\.\@@.@.*.##*..#
#... .*@..!..\...*.#
#...*.\ W..\.W.. @\#
##*..\.. ..\*..*..\#
###*......*#.*@*.. #
####################

